----------------------------------|
                                  |
                                  |
     -----------------------------|
-                                -|
-           ------               -|
----           *         --     --|
-            --                  -|
-                                -|
-     ----*                   ----|
-                                -|
--                   ----        -|
-              ---               -|
--                               -|
-                                -|
-                            --- -|
-                                -|
-                                -|
-      ---                       -|
-                                -|
-   --------        ----         -|
-                                -|
-                         -      -|
-                            --  -|
-                                -|
-                                -|
---------------              --  -|
-              ----------------- -|
-                                -|
----------------------------------|