----------------------------------|
                                  |
                                  |
     -----------------------------|
-                                -|
-           ------               -|
----           *         --     --|
-            --                  -|
-                                -|
-     ----*                   ----|
-                                -|
--              M    ----        -|
-              ---               -|
--                               -|
-              M                 -|
-          ---------         --- -|
-                                -|
-                                -|
-      ---                       -|
-                                -|
-   --------        ----         -|
-                                -|
-                         -      -|
-                            --  -|
-                                -|
-           M                    -|
---------------              --  -|
-              ----------------- -|
-                M               -|
----------------------------------|